aalib: Portable ASCII art graphics library
angular-cli: CLI tool for Angular
ansiweather: Weather in your terminal, with ANSI colors and Unicode symbols
aom: Codec library for encoding and decoding AV1 video streams
asciiquarium: Aquarium animation in ASCII art
assimp: Portable library for importing many well-known 3D model formats
autoconf: Automatic configure script builder
automake: Tool for generating GNU Standards-compliant Makefiles
aview: ASCII-art image browser and animation viewer
bandwhich: Terminal bandwidth utilization tool
bash: Bourne-Again SHell, a UNIX command interpreter
bash-completion: Programmable completion for Bash 3.2
bash-git-prompt: Informative, fancy bash prompt for Git users
bat: Clone of cat(1) with syntax highlighting and Git integration
bdw-gc: Garbage collector for C and C++
berkeley-db: High performance key/value database
brew-cask-completion: Fish completion for brew-cask
c-ares: Asynchronous DNS library
cairo: Vector graphics library with cross-device output support
cask: Emacs dependency management
cataclysm: Fork/variant of Cataclysm Roguelike
cf-cli: [no description]
cmark-gfm: C implementation of GitHub Flavored Markdown
cmatrix: Console Matrix
coreutils: GNU File, Shell, and Text utilities
cowsay: Configurable talking characters in ASCII art
ctags: Reimplementation of ctags(1)
dart: The Dart SDK
dav1d: AV1 decoder targeted to be small and fast
dbus: Message bus system, providing inter-application communication
deno: Secure runtime for JavaScript and TypeScript
docker: Pack, ship and run any application as a lightweight container
double-conversion: Binary-decimal and decimal-binary routines for IEEE doubles
emacs: GNU Emacs text editor
ffmpeg: Play, record, convert, and stream audio and video
figlet: Banner-like program prints strings as ASCII art
flac: Free lossless audio codec
fontconfig: XML-based font configuration API for X Windows
fortune: Infamous electronic fortune-cookie generator
freetype: Software library to render fonts
frei0r: Minimalistic plugin API for video effects
fribidi: Implementation of the Unicode BiDi algorithm
gd: Graphics library to dynamically manipulate images
gdb: GNU debugger
gdbm: GNU database manager
gdk-pixbuf: Toolkit for image loading and pixel buffer manipulation
gettext: GNU internationalization (i18n) and localization (l10n) library
gh: GitHub command-line tool
ghc: Glorious Glasgow Haskell Compilation System
giflib: Library and utilities for processing GIFs
git: Distributed revision control system
git-lfs: Git extension for versioning large files
glfw: Multi-platform library for OpenGL applications
glib: Core application library for C
global: Source code tag system
gmp: GNU multiple precision arithmetic library
gnu-indent: C code prettifier
gnu-typist: GNU typing tutor
gnu-units: GNU unit conversion tool
gnutls: GNU Transport Layer Security (TLS) Library
gobject-introspection: Generate introspection data for GObject libraries
googler: Google Search and News from the command-line
gradle: Open-source build automation tool based on the Groovy and Kotlin DSL
graphite2: Smart font renderer for non-Roman scripts
graphviz: Graph visualization software from AT&T and Bell Labs
grep: GNU grep, egrep and fgrep
grip: GitHub Markdown previewer
gts: GNU triangulated surface library
guile: GNU Ubiquitous Intelligent Language for Extensions
harfbuzz: OpenType text shaping engine
heroku: Everything you need to get started with Heroku
heroku-node: node.js dependency for heroku
historian: Command-line utility for managing shell history in a SQLite database
htop: Improved top (interactive process viewer)
http-server: Simple zero-configuration command-line HTTP server
icu4c: C/C++ and Java libraries for Unicode and globalization
jansson: C library for encoding, decoding, and manipulating JSON
jasper: Library for manipulating JPEG-2000 images
jemalloc: Implementation of malloc emphasizing fragmentation avoidance
jenkins: Extendable open source continuous integration server
jenv: Manage your Java environment
jmeter: Load testing and performance measurement application
jpeg: Image manipulation library
jq: Lightweight and flexible command-line JSON processor
krb5: Network authentication protocol
lame: High quality MPEG Audio Layer III (MP3) encoder
leptonica: Image processing and image analysis library
libass: Subtitle renderer for the ASS/SSA subtitle format
libb2: Secure hashing function
libbluray: Blu-Ray disc playback library for media players like VLC
libev: Asynchronous event library
libevent: Asynchronous event library
libffi: Portable Foreign Function Interface library
libidn2: International domain name library (IDNA2008, Punycode and TR46)
libmodplug: Library from the Modplug-XMMS project
libogg: Ogg Bitstream Library
libpng: Library for manipulating PNG images
libproxy: Library that provides automatic proxy configuration management
libpthread-stubs: X.Org: pthread-stubs.pc
librsvg: Library to render SVG files using Cairo
libsamplerate: Library for sample rate conversion of audio data
libsndfile: C library for files containing sampled sound
libsodium: NaCl networking and cryptography library
libsoxr: High quality, one-dimensional sample-rate conversion library
libssh2: C library implementing the SSH2 protocol
libtasn1: ASN.1 structure parser library
libtiff: TIFF library and utilities
libtool: Generic library support script
libunistring: C string library for manipulating Unicode strings
libvidstab: Transcode video stabilization plugin
libvorbis: Vorbis General Audio Compression Codec
libvpx: VP8/VP9 video codec
libx11: X.Org: Core X11 protocol client library
libxau: X.Org: A Sample Authorization Protocol for X
libxcb: X.Org: Interface to the X Window System protocol
libxdmcp: X.Org: X Display Manager Control Protocol library
libxext: X.Org: Library for common extensions to the X11 protocol
libxrender: X.Org: Library for the Render Extension to the X11 protocol
libyaml: YAML Parser
libzip: C library for reading, creating, and modifying zip archives
little-cms2: Color management engine supporting ICC profiles
lolcat: Rainbows and unicorns in your console!
lsd: Clone of ls with colorful output, file type icons, and more
lua: Powerful, lightweight programming language
lynx: Text-based web browser
lzo: Real-time data compression library
markdown: Text-to-HTML conversion tool
maven: Java-based project management
maven-completion: Bash completion for Maven
mit-scheme: MIT/GNU Scheme development tools and runtime library
mongodb-community: High-performance, schema-free, document-oriented database
mongodb-database-tools: This package contains standard utilities for interacting with MongoDB.
mono: Cross platform, open source .NET development framework
monolith: CLI tool for saving complete web pages as a single HTML file
mpdecimal: Library for decimal floating point arithmetic
mysql: Open source relational database management system
ncdu: NCurses Disk Usage
ncurses: Text-based UI library
netpbm: Image manipulation
nettle: Low-level cryptographic library
nghttp2: HTTP/2 C Library
node: Platform built on V8 to build network applications
oniguruma: Regular expressions library
opencore-amr: Audio codecs extracted from Android open source project
openjdk: Development kit for the Java programming language
openjdk@11: Development kit for the Java programming language
openjpeg: Library for JPEG-2000 image manipulation
openssl@1.1: Cryptography and SSL/TLS Toolkit
opus: Audio codec
osx-cpu-temp: Outputs current CPU temperature for OSX
p11-kit: Library to load and enumerate PKCS#11 modules
pango: Framework for layout and rendering of i18n text
pcre: Perl compatible regular expressions library
pcre2: Perl compatible regular expressions library with a new API
perl: Highly capable, feature-rich programming language
springboot: [no description]
pixman: Low-level library for pixel manipulation
pkg-config: Manage compile and link flags for libraries
plantuml: Draw UML diagrams
postgresql: Object-relational database system
progress: Coreutils progress viewer
protobuf: Protocol buffers (Google's data interchange format)
protobuf@3.7: Protocol buffers (Google's data interchange format)
python@3.8: Interpreted, interactive, object-oriented programming language
python@3.9: Interpreted, interactive, object-oriented programming language
qt: Cross-platform application and UI framework
qt@5: Cross-platform application and UI framework
rav1e: Fastest and safest AV1 video encoder
readline: Library for command-line editing
redis: Persistent key-value database, with built-in net interface
rogue: Dungeon crawling video game
rtmpdump: Tool for downloading RTMP streaming media
rubberband: Audio time stretcher tool and library
ruby: Powerful, clean, object-oriented scripting language
rust: Safe, concurrent, practical language
sass: Stylesheet Preprocessor
sbt: Build tool for Scala projects
screenfetch: Generate ASCII art with terminal, shell, and OS info
sdl2: Low-level access to audio, keyboard, mouse, joystick, and graphics
sdl2_image: Library for loading images as SDL surfaces and textures
sdl2_mixer: Sample multi-channel audio mixer library
sdl2_ttf: Library for using TrueType fonts in SDL applications
shfmt: Autoformat shell script source code
sl: Prints a steam locomotive if you type sl instead of ls
snappy: Compression/decompression library aiming for high speed
speex: Audio codec designed for speech
sqlite: Command-line interface for SQLite
sqlmap: Penetration testing for SQL injection and database servers
srt: Secure Reliable Transport
task: Feature-rich console based todo list manager
tcl-tk: Tool Command Language
telnet: User interface to the TELNET protocol
terminal-notifier: Send macOS User Notifications from the command-line
tesseract: OCR (Optical Character Recognition) engine
thefuck: Programmatically correct mistyped console commands
theora: Open video compression format
tldr: Simplified and community-driven man pages
tmux: Terminal multiplexer
tnftp: NetBSD's FTP client
tomcat: Implementation of Java Servlet and JavaServer Pages
travis: Command-line client for Travis CI
tree: Display directories as trees (with optional color/HTML output)
tty-clock: Digital clock in ncurses
tty-solitaire: Ncurses-based klondike solitaire game
unbound: Validating, recursive, caching DNS resolver
utf8proc: Clean C library for processing UTF-8 Unicode data
vim: Vi 'workalike' with many additional features
watch: Executes a program periodically, showing output fullscreen
webp: Image format providing lossless and lossy compression for web images
wget: Internet file retriever
x264: H.264/AVC encoder
x265: H.265/HEVC encoder
xorgproto: X.Org: Protocol Headers
xpdf: PDF viewer
xvid: High-performance, high-quality MPEG-4 video library
xz: General-purpose data compression with high compression ratio
z: Tracks most-used directories to make cd smarter
zeromq: High-performance, asynchronous messaging library
zimg: Scaling, colorspace conversion, and dithering library
zsh: UNIX shell (command interpreter)
zstd: Zstandard is a real-time compression algorithm
discord
firefox
font-hack-nerd-font
github
google-chrome
intellij-idea-ce
iterm2
mono-mdk
postman
racket
rectangle
robo-3t
slack
spotify
steam
tor-browser
twitch
visual-studio-code
vlc
